{
  "map": [
    "##########",
    "#.....U..#",
    "#P.OOO.U.#",
    "#.....U..#",
    "##########"
  ]
}