{
  "map": [
    "########.",
    "#U.....#.",
    "####.#O##",
    "...#....#",
    ".###.#OU#",
    ".#P..#..#",
    ".###....#",
    "...#....#",
    "...######"
  ]
}