{
  "map": [
    "##########.",
    "#P....U#.#.",
    "#.##.#.#.#.",
    "#U...#...##",
    "#.#.O#.#..#",
    "#.U.....O.#",
    "###.#######",
    "..#..#.....",
    "..#O.#.....",
    "..#..#.....",
    "..####....."
  ]
}